0 	0 	0 	0 	0 	0 	0 	1 	2 	0 	0 	0 	0 	0 	0 	0 	0 	0 	0 	0 	0 	0 	0 	0 	0 	0
0 	0 	0 	0 	0 	0 	0 	1 	2 	0 	0 	0 	0 	0 	0 	0 	0 	0 	0 	0 	0 	0 	0 	0 	0 	0
0 	0 	0 	0 	0 	0 	0 	1 	2 	0 	0 	0 	0 	0 	0 	0 	0 	0 	0 	0 	0 	0 	0 	0 	0 	0
0 	0 	0 	0 	0 	0 	0 	1 	2 	2 	2 	2 	2 	2 	2 	2 	2 	2 	2 	2 	2 	0 	0 	0 	0 	0
0 	0 	0 	0 	0 	0 	0 	1 	1 	1 	1 	1 	1 	1 	1 	1 	1 	1 	1 	1 	2 	0 	0 	0 	0 	0
0 	0 	0 	0 	0 	0 	0 	0 	0 	0 	0 	0 	0 	0 	0 	0 	0 	0 	0 	1 	2 	0 	0 	0 	0 	0
0 	0 	0 	0 	0 	0 	0 	0 	0 	0 	0 	0 	0 	0 	0 	0 	0 	0 	0 	1 	2 	0 	0 	0 	0 	0
0 	0 	1 	1 	1 	1 	1 	1 	1 	1 	1 	1 	1 	1 	1 	1 	1 	1 	1 	1 	2 	0 	0 	0 	0 	0
0 	0 	1 	2 	2 	2 	2 	2 	2 	2 	2 	2 	2 	2 	2 	2 	2 	2 	2 	2 	2 	0 	0 	0 	0 	0
0 	0 	1 	2 	0 	0 	0 	0 	0 	0 	0 	0 	0 	0 	0 	0 	0 	0 	0 	0 	0 	0 	0 	0 	0 	0
0 	0 	1 	2 	0 	0 	0 	0 	0 	0 	0 	0 	0 	0 	0 	0 	0 	0 	0 	0 	0 	0 	0 	0 	0 	0
0 	0 	1 	2 	2 	2 	2 	2 	2 	2 	2 	0 	0 	0 	0 	0 	0 	0 	0 	0 	0 	0 	0 	0 	0 	0
0 	0 	1	1 	1 	1 	1 	1 	1 	1 	2 	0 	0 	0 	0 	0 	0 	0 	0 	0 	0 	0 	0 	0 	0 	0
0 	0 	0	0 	0 	0 	0 	0 	0 	1 	2 	0 	0 	0 	0 	0 	0 	0 	0 	0 	0 	0 	0 	0 	0 	0
0 	0 	0 	0 	0 	0 	0 	0 	0 	1 	2 	2 	2 	2 	2 	2 	2 	2 	2 	2 	2 	2 	2 	2 	2 	0
0 	0 	0 	0 	0 	0 	0 	0 	0 	1 	1 	1 	1 	1 	1 	1 	1 	1 	1 	1 	1 	1 	1 	1 	2 	0
0 	0 	0 	0 	0 	0 	0 	0 	0 	0 	0 	0 	0 	0 	0 	0 	0 	0 	0 	0 	0 	0 	0 	1 	2 	0
0 	0 	0 	0 	0 	0 	0 	0 	0 	0 	0 	0 	0 	0 	0 	1 	1 	1 	1 	1 	1 	1 	1 	1 	2 	0
0 	0 	0 	0 	0 	0 	0 	0 	0 	0 	0 	0 	0 	0 	0 	1 	2 	2 	2 	2 	2 	2 	2	2 	2 	0
0 	0 	0 	0 	0 	0 	0 	0 	0 	0 	0 	0 	0 	0 	0 	3 	4 	0 	0 	0 	0 	0 	0 	0 	0 	0

17 	17 	17 	17 	17 	17 	17 	3 	2 	17 	17 	17 	17 	17 	17 	17 	17 	17 	17 	17 	17 	17 	17 	17 	17 	17
17 	17 	17 	17 	17 	17 	17 	9 	15 	17 	17 	17 	17 	17 	17 	17 	17 	17 	17 	17 	17 	17 	17 	17 	17 	17
17 	17 	17 	17 	17 	17 	17 	9 	15 	17 	17 	17 	17 	17 	17 	17 	17 	17 	17 	17 	17 	17 	17 	17 	17 	17
17 	17 	17 	17 	17 	17 	17 	9 	16 	10 	10 	10 	10 	10 	10 	10 	10 	10 	10 	10 	8 	17 	17 	17 	17 	17
17 	17 	17 	17 	17 	17 	17 	14 	11 	11 	11 	11 	11 	11 	11 	11 	11 	11 	11 	19 	15 	17 	17 	17 	17 	17
17 	17 	17 	17 	17 	17 	17 	17 	17 	17 	17 	17 	17 	17 	17 	17 	17 	17 	17 	9 	15 	17 	17 	17 	17 	17
17 	17 	17 	17 	17 	17 	17 	17 	17 	17 	17 	17 	17 	17 	17 	17 	17 	17 	17 	9 	15 	17 	17 	17 	17 	17
17 	17 	13 	10 	10 	10 	10 	10 	10 	10 	10 	10 	10 	10 	10 	10 	10 	10 	10 	20 	15 	17 	17 	17 	17 	17
17 	17 	9 	18 	11 	11 	11 	11 	11 	11 	11 	11 	11 	11 	11 	11 	11 	11 	11 	11 	12 	17 	17 	17 	17 	17
17 	17 	9 	15 	17 	17 	17 	17 	17 	17 	17 	17 	17 	17 	17 	17 	17 	17 	17 	17 	17 	17 	17 	17 	17 	17
17 	17 	9 	15 	17 	17 	17 	17 	17 	17 	17 	17 	17 	17 	17 	17 	17 	17 	17 	17 	17 	17 	17 	17 	17 	17
17 	17 	9 	16 	10 	10 	10 	10 	10 	10 	8 	17 	17 	17 	17 	17 	17 	17 	17 	17 	17 	17 	17 	17 	17 	17
17 	17 	14	11 	11 	11 	11 	11 	11 	19 	15 	17 	17 	17 	17 	17 	17 	17 	17 	17 	17 	17 	17 	17 	17 	17
17 	17 	17	17 	17 	17 	17 	17 	17 	9 	15 	17 	17 	17 	17 	17 	17 	17 	17 	17 	17 	17 	17 	17 	17 	17
17 	17 	17 	17 	17 	17 	17 	17 	17 	9 	16 	10 	10 	10 	10 	10 	10 	10 	10 	10 	10 	10 	10 	10 	8 	17
17 	17 	17 	17 	17 	17 	17 	17 	17 	14 	11 	11 	11 	11 	11 	11 	11 	11 	11 	11 	11 	11 	11 	19 	15 	17
17 	17 	17 	17 	17 	17 	17 	17 	17 	17 	17 	17 	17 	17 	17 	17 	17 	17 	17 	17 	17 	17 	17 	9 	15 	17
17 	17 	17 	17 	17 	17 	17 	17 	17 	17 	17 	17 	17 	17 	17 	13 	10 	10 	10 	10 	10 	10 	10 	20 	15 	17
17 	17 	17 	17 	17 	17 	17 	17 	17 	17 	17 	17 	17 	17 	17 	9 	18 	11 	11 	11 	11 	11 	11 	11 	12 	17
17 	17 	17 	17 	17 	17 	17 	17 	17 	17 	17 	17 	17 	17 	17 	5 	7 	17 	17 	17 	17 	17 	17 	17 	17 	17