0 	0 	0 	0 	1 	0 	0 	0 	0 	0 	0 	0 	0	0 	0 	0 	0 	0 	0 	0 	0 	2 	0 	0 	0 	0
0 	0 	0 	0 	1 	0 	0 	0 	0 	0 	0 	0 	0	0 	0 	0 	0 	0 	0 	0 	0 	2 	0 	0 	0 	0
0 	0 	0 	0 	1 	0 	0 	0 	0 	0 	0 	0 	0	0 	0 	0 	0 	0 	0 	0 	0 	2 	0 	0 	0 	0
0 	0 	0 	0 	1 	0 	0 	0	0 	0 	0 	0 	0	0 	0 	0 	0 	0 	0 	0 	0 	2 	0 	0 	0 	0
0 	0 	0 	0 	1 	1 	1 	1 	1 	1 	1 	1	0	0 	2 	2 	2 	2 	2 	2 	2 	2 	0 	0 	0 	0
0 	0 	0 	0 	0 	0 	0 	0 	0 	0 	0 	1 	0	0 	2 	0 	0 	0 	0 	0 	0 	0 	0 	0 	0 	0
0 	0 	0 	0 	0 	0 	0 	0 	0 	0 	0 	1 	0	0 	2 	0 	0 	0 	0 	0 	0 	0 	0 	0 	0 	0
0 	0 	0 	0 	1 	1 	1 	1 	0 	0 	0 	1 	0	0 	2 	0 	0 	0 	2 	2 	2 	2 	0 	0 	0 	0
0 	0 	0 	0 	1 	0 	0 	1 	0 	0 	0 	1 	0	0 	2 	0 	0 	0 	2 	0 	0 	2 	0 	0 	0 	0
0 	0 	0 	0 	1 	0 	0 	1 	0 	0 	0 	1 	0	0 	2 	0 	0 	0 	2 	0 	0 	2 	0 	0 	0 	0
0 	0 	0 	0 	1 	0 	0 	1 	1 	1 	1 	1 	0	0 	2 	2 	2 	2 	2 	0 	0 	2 	0 	0 	0 	0
0 	0 	0 	0 	1 	0 	0 	0 	0 	0 	0 	0 	0	0 	0 	0 	0 	0 	0 	0 	0 	2 	0 	0 	0 	0
0 	0 	0 	0 	1 	0 	0 	0 	0 	0 	0 	0 	0	0 	0 	0 	0 	0 	0 	0 	0 	2 	0 	0 	0 	0
0 	0 	0 	0 	1 	0 	0 	0 	0 	0 	0 	0 	0	0 	0 	0 	0 	0 	0 	0 	0 	2 	0 	0 	0 	0
0 	0 	0 	0 	1 	0 	0 	0 	0 	0 	0 	0 	0	0 	0 	0 	0 	0 	0 	0 	0 	2 	0 	0 	0 	0
0 	0 	0 	0 	1 	1 	1 	1 	1 	1 	1 	1 	0	0 	2 	2 	2 	2 	2 	2 	2 	2 	0 	0 	0 	0
0 	0 	0 	0 	0 	0 	0 	0 	0 	0 	0 	1 	0	0 	2 	0 	0 	0 	0 	0 	0 	0 	0 	0 	0 	0
0 	0 	0 	0 	0 	0 	0 	0 	0 	0 	0 	1 	0	0 	2 	0 	0 	0 	0 	0 	0 	0 	0 	0 	0 	0
0 	0 	0 	0 	0 	0 	0 	0 	0 	0 	0 	1 	0	0 	2 	0 	0 	0 	0 	0 	0 	0 	0 	0 	0 	0
0 	0 	0 	0 	0 	0 	0 	0 	0 	0 	0 	3 	0	0 	4 	0 	0 	0 	0 	0 	0 	0 	0 	0 	0 	0

17 	17 	17 	17 	1 	17 	17 	17 	17 	17 	17 	17 	17	17 	17 	17 	17 	17 	17 	17 	17 	1 	17 	17 	17 	17
17 	17 	17 	17 	0 	17 	17 	17 	17 	17 	17 	17 	17	17 	17 	17 	17 	17 	17 	17 	17 	0 	17 	17 	17 	17
17 	17 	17 	17 	0 	17 	17 	17 	17 	17 	17 	17 	17	17 	17 	17 	17 	17 	17 	17 	17 	0 	17 	17 	17 	17
17 	17 	17 	17 	0 	17 	17 	17	17 	17 	17 	17 	17	17 	17 	17 	17 	17 	17 	17 	17 	0 	17 	17 	17 	17
17 	17 	17 	17 	14 	6 	6 	6 	6 	6 	6 	8	17	17 	13 	6 	6 	6 	6 	6 	6 	12 	17 	17 	17 	17
17 	17 	17 	17 	17 	17 	17 	17 	17 	17 	17 	0 	17	17 	0 	17 	17 	17 	17 	17 	17 	17 	17 	17 	17 	17
17 	17 	17 	17 	17 	17 	17 	17 	17 	17 	17 	0 	17	17 	0 	17 	17 	17 	17 	17 	17 	17 	17 	17 	17 	17
17 	17 	17 	17 	13 	6 	6 	8 	17 	17 	17 	0 	17	17 	0 	17 	17 	17 	13 	6 	6 	8 	17 	17 	17 	17
17 	17 	17 	17 	0 	17 	17 	0 	17 	17 	17 	0 	17	17 	0 	17 	17 	17 	0 	17 	17 	0 	17 	17 	17 	17
17 	17 	17 	17 	0 	17 	17 	0 	17 	17 	17 	0 	17	17 	0 	17 	17 	17 	0 	17 	17 	0 	17 	17 	17 	17
17 	17 	17 	17 	0 	17 	17 	14 	6 	6 	6 	12 	17	17 	14 	6 	6 	6 	12 	17 	17 	0 	17 	17 	17 	17
17 	17 	17 	17 	0 	17 	17 	17 	17 	17 	17 	17 	17	17 	17 	17 	17 	17 	17 	17 	17 	0 	17 	17 	17 	17
17 	17 	17 	17 	0 	17 	17 	17 	17 	17 	17 	17 	17	17 	17 	17 	17 	17 	17 	17 	17 	0 	17 	17 	17 	17
17 	17 	17 	17 	0 	17 	17 	17 	17 	17 	17 	17 	17	17 	17 	17 	17 	17 	17 	17 	17 	0 	17 	17 	17 	17
17 	17 	17 	17 	0 	17 	17 	17 	17 	17 	17 	17 	17	17 	17 	17 	17 	17 	17 	17 	17 	0 	17 	17 	17 	17
17 	17 	17 	17 	14 	6 	6 	6 	6 	6 	6 	8 	17	17 	13 	6 	6 	6 	6 	6 	6 	12 	17 	17 	17 	17
17 	17 	17 	17 	17 	17 	17 	17 	17 	17 	17 	0 	17	17 	0 	17 	17 	17 	17 	17 	17 	17 	17 	17 	17 	17
17 	17 	17 	17 	17 	17 	17 	17 	17 	17 	17 	0 	17	17 	0 	17 	17 	17 	17 	17 	17 	17 	17 	17 	17 	17
17 	17 	17 	17 	17 	17 	17 	17 	17 	17 	17 	0 	17	17 	0 	17 	17 	17 	17 	17 	17 	17 	17 	17 	17 	17
17 	17 	17 	17 	17 	17 	17 	17 	17 	17 	17 	4 	17	17 	4 	17 	17 	17 	17 	17 	17 	17 	17 	17 	17 	17